############
#    P     #
#          #
#    O   X #
############
